互聯網	網際網路
存儲空間	儲存空間
移動營運商	電信業者
剪貼板	剪貼簿
加載	載入
皮膚	造型
信息	資訊
充值	儲值
揹包	背包
包裹	背包
服務器	伺服器
登錄	登入
數據	資料
移動網絡	行動網路
網絡	網路
運營	營運
菜單	選單 菜單
回復	恢復
回覆	恢復
迴應	回應
賬號	帳號
字符	字元
界面	介面
短信	簡訊
座標	坐標
視頻	影片
隻能	只能
訓練	練習
紅桃	紅心
默認	預設
標簽	標籤
補籤	補簽
神祕	神秘
託管	托管
動盪	動蕩
平臺	平台
圖像	影象
圖庫	相簿
武勳	武勛
功勳	武勛
後臺	後台
周榜	週榜
周貢獻	週貢獻
臥	卧
封禁	封鎖
拼音	注音
漢字	中文字
曆程	歷程
佔用	占用
准備	準備
夥伴	伙伴
麼麼噠	啾咪
相冊	相簿
祕	秘
賬	帳
鏈接	連結
千裡	千里
併	並
合並	合併
